  ###
  #  
# # #
#   #
### E
POSITIONS 0 0 0 0			###########
				#         #
				# #### ## #
				# #   # # #
				###   # # #
				# ####### #
				#         #
				#########E#