##################
#                #
###### #### ## # #              
#   #   # #  # # # 
#   #   # #  # # #        
#   #   # #  # # # 
#   # ##  #  # # #       
#      #     # # #
######## ####### #      
#         #    # #
#  # ###  # ###  #      
#  # # #  #    # #
#  # # #  #### # #        
#  # # ## #### # #
#  # #         # #
##############E###